Drake - God's Plan
Kendrick Lamar - HUMBLE.
Post Malone - Rockstar
Travis Scott - SICKO MODE
Lil Baby - Drip Too Hard
Megan Thee Stallion - Savage
Cardi B - WAP
Lil Nas X - Old Town Road
Juice WRLD - Lucid Dreams
Drake - In My Feelings
21 Savage - A Lot
J. Cole - Middle Child
Future - Mask Off
Kanye West - Praise God
Doja Cat - Say So
Travis Scott - Goosebumps
DaBaby - Suge
Migos - Bad and Boujee
A$AP Rocky - Praise the Lord (Da Shine)
Nicki Minaj - Super Bass
Lil Uzi Vert - XO TOUR Llif3
Post Malone - Circles
Drake - Nonstop
Travis Scott - Antidote
Lil Durk - All My Life
Harry Styles - As It Was
Taylor Swift - Anti-Hero
Olivia Rodrigo - Vampire
Miley Cyrus - Flowers
Dua Lipa - Don't Start Now
The Weeknd - Blinding Lights
Adele - Easy On Me
Sam Smith - Unholy
Lizzo - About Damn Time
Ed Sheeran - Shape of You
Billie Eilish - Bad Guy
Doja Cat - Say So
Selena Gomez - Lose You to Love Me
Justin Bieber - Peaches
Rihanna - Work
Ariana Grande - Thank U, Next
Shawn Mendes - Señorita
Katy Perry - Roar
Beyoncé - Break My Soul
Lady Gaga - Shallow
Bruno Mars - Uptown Funk
Khalid - Young Dumb & Broke
Halsey - Without Me
Tove Lo - Habits (Stay High)
Charlie Puth - Attention
Foo Fighters - Shame Shame
The Killers - Caution
Måneskin - Beggin'
Royal Blood - Out of the Black
Red Hot Chili Peppers - Tippa My Tongue
Shinedown - Planet Zero
Paramore - This Is Why
The Strokes - Bad Decisions
Muse - Won't Stand Down
Kings of Leon - Waste a Moment
Greta Van Fleet - Safari Song
Ghost - Rats
Halestorm - I Am the Fire
Alter Bridge - Addicted to Pain
Slipknot - Unsainted
Foo Fighters - The Pretender
Tool - Fear Inoculum
Linkin Park - Heavy
The 1975 - If You're Too Shy (Let Me Know)
Bring Me the Horizon - Can You Feel My Heart
Arctic Monkeys - Do I Wanna Know?
The White Stripes - Icky Thump
Limp Bizkit - Dad Vibes
System of a Down - Chop Suey!
Five Seconds of Summer - Teeth
Luke Combs - Beer Never Broke My Heart
Kacey Musgraves - Follow Your Arrow
Chris Stapleton - Tennessee Whiskey
Miranda Lambert - Bluebird
Blake Shelton - God's Country
Thomas Rhett - Die a Happy Man
Maren Morris - The Bones
Carrie Underwood - Before He Cheats
Jason Aldean - Burnin' It Down
Cole Swindell - You Should Be Here
Florida Georgia Line - Meant to Be
Sam Hunt - Body Like a Back Road
Dan + Shay - Tequila
Zac Brown Band - Chicken Fried
Keith Urban - Blue Ain't Your Color
Luke Bryan - Play It Again
Dierks Bentley - Drunk on a Plane
Shania Twain - Life's About to Get Good
Eric Church - Springsteen
Little Big Town - Girl Crush
Brothers Osborne - Stay a Little Longer
Jason Isbell - If We Were Vampires
Travis Tritt - It's a Great Day to Be Alive
Keith Urban - The Fighter
Hunter Hayes - Wanted